NO ./assets/test_NO.xpm
SO ./assets/test_SO.xpm
WE ./assets/test_WE.xpm
EA ./assets/test_EA.xpm

F 0,0,0
C 100,100,200

1111111111111111
1000000000000001
1E00010000000001
1000000000000001
1000000000000001
1000100000000001
1000000000000001
1000000000000001
1000000000000001
1111111111111111